tileswide 11
tileshigh 8
tilewidth 16
tileheight 16

layer 0
0,0,1,3,3,3,3,3,3,0,0,
0,0,1,3,3,3,3,3,3,0,0,
0,0,1,3,3,3,3,3,3,0,0,
0,0,1,3,3,3,3,3,3,0,0,
0,0,0,1,1,1,0,0,0,0,0,
0,0,0,0,0,0,0,0,0,0,0,
0,0,0,0,0,0,0,0,0,0,0,
0,0,0,0,0,0,0,0,0,0,0,

